Background1
#.........................#
#.........................#
#.........................#
#.........................#
#.........................#
#.........................#
#.........................#
#.........................#
#.........................#
#.........................#
#.......................E.#
#......................BBB#
#.1....................B..#
#.................D....B..#
########A###A##############