Background1
#.........................#
#.........................#
#.........................#
#.........................#
#.........................#
#..............###D.......#
#..............XXDD.......#
#...............XSX.......#
#................SX.......#
#.....C......P######......#
#######.....#########.....#
#.....X.....###....DD.....#
#..1..X...D.###....DS.....#
#.....X..######...EXX.....#
######################AAA##