Background2
#.........................#
#.........................#
#...................BBBB..#
#..................B..D.B.#
#.......BBBBB......B.DD.B.#
#......B.DDD.B.......SS...#
#........XXX.B.........S..#
#...........CB............#
#............B.......SS.E.#
#........XXX.B.B........BB#
#............B............#
#..B...FF........B........#
#..1.T....................#
#....#.......#.....########
######AAAAAAA##############
###########################