Background1
#................C........#
#..........#...D..........#
#..............D..........#
#............#.D..........#
#..............D..........#
#..........#...D..........#
#..............D........E.#
#............###.......####
#......D.....#.#.......####
#......D.....#.#.......####
#...#..D...###.#.......####
#......D..#....#AAAAAAA####
###1...D.#.....############
#......D#.................#
###########################